NO ./path_to_the_north_texture



SO ./path_to_the_south_texture
WE ./path_to_the_west_texture

EA              ./path_to_the_east_texture
F 240,				100,43


C 225,30,45

1111
1001
10S1
1111