NO ./path_to_the_north_texture




SO ./path_to_the_south_texture
WE ./path_to_the_west_texture

EA              ./path_to_the_east_texture

F 220,				100,0


C 225,30,0

1111
1011
11
1111111111111111111111111
1000000000110000000000001
1011000001110000000000001
1001000000000000000000001
11111111101100000111000001111
1000000000110000011101111101011
11110111111111S11100000010001
11110111111111011101010010001
11000000110111011100000010001
10000000000000001100000010001
10000000000000001101010010001
1100000111010101111101111010111
11110111 1110101 101111010001
11111111 1111111 111111111111
11